80 22
11111111111111111111111111111111111111111111111111111111111111111111111111111111
10000000000000000000000000000000000000000000000000000000000000000000000000000001
10000000000000000000000000000000000000000000000000000000000111000000000000000001
10000000000000000000000000000000000000000000000000000000000111000000000000000001
10000000000111100000000000000000000000000000000000000000000111000000000000000001
10000000000111100000000000000000000000000000000000000000000000000000000000000001
10000000000111100000000000000000000000000000000000000000000000000000000000000001
10000000000111100000000000000000000000000000000000000000000000000000000000000001
10000000000000000000000000000000000000000000000000000000000000000000000000000001
10000000000000000000000000000000000000000000000000000000000000000000000000000001
1000000000000000000000000000000000000000S000000000000000000000000000000000000001
10000000000000000000000000000000000000000000000000000000000000000000000000000001
10000000000000000000000000000000000000000000000000000000000000000000000000000001
10000000000000000000000000000000000000000000000000000000000000000000000000000001
10000000000000000000000000000000000000000000001111111111000000000000000000000001
10000000000000000000000000000000000000000000001111111111000000000000000000000001
10000000000000000000000000000000000000000000001111111111000000000000000000000001
10000000000000000000000000000000000000000000001111111111000000000000000000000001
10000000000000000000000000000000000000000000000000000000000000000000000000000001
10000000000000000000000000000000000000000000000000000000000000000000000000000001
10000000000000000000000000000000000000000000000000000000000000000000000000000001
11111111111111111111111111111111111111111111111111111111111111111111111111111111