60 15
111111111111111111111111111111111111111111111111111111111111
100000000000000000000000000000000000000000000000000000000001
100000000000000000000000000000000000000000000000000000000001
1000S0000000000000000000000000000000000011000000000000000001
100000000000000000000000000000000000000011000000000000000001
100000000001100000000000000000000000000011000000000000000001
100000000001100000000000000000000000000000000000000000000001
100000000000000000000111000000000000000000000000000000000001
100000000000000000000111000000000000000000000000000000000001
100000000000000000000111000000000000010000000000010000000001
100000000001100000000000000000000000001100100000110000000001
100000000001100000000000000000000000000010000000110000000001
100000000000000000000000000000000000000001000000100000000001
100000000000000000000000000000000000000000000000000000000001
111111111111111111111111111111111111111111111111111111111111