60 15
############################################################
#                                                          #
#                                                          #
#   S                                   ##                 #
#                                       ##                 #
#          ##                           ##                 #
#          ##                                              #
#                    ###                                   #
#                    ###                                   #
#                    ###             #           #         #
#          ##                         ##  #     ##         #
#          ##                           #       ##         #
#                                        #      #          #
#                                                          #
############################################################